MODE 2
SIZE 9/6
LIMIT 0/16
COLOR LIMIT 4
STARS 800/1300/1950
COLLECT COUNT 0/4
COLLECT ITEMS 1/2
00 00 10 10 10 10 10 00 00
00 10 10 10 10 10 10 10 00
10 10 10 10 10 10 10 10 10
10 10 10 10 10 10 10 10 10
10 10 10 10 10 10 10 10 10
10 10 10 10 10 10 10 10 10