MODE 2
SIZE 9/11
LIMIT 0/25
COLOR LIMIT 4
STARS 1000/2500/3800
COLLECT COUNT 0/3
COLLECT ITEMS 0/2
00 00 00 10 10 10 00 00 00
00 00 00 10 10 10 00 00 00
00 00 10 10 10 10 10 00 00
00 00 10 10 10 10 10 00 00
00 10 10 10 10 10 10 10 00
00 10 10 10 10 10 10 10 00
10 10 10 10 14 10 10 10 10
10 10 10 14 14 14 10 10 10
14 14 14 14 14 14 14 14 14
10 14 14 14 14 14 14 14 10
10 10 14 14 14 14 14 10 10