MODE 1
SIZE 9/11
LIMIT 0/19
COLOR LIMIT 6
STARS 4500/5600/6700
COLLECT COUNT 20/20
COLLECT ITEMS 1/4
10 10 10 10 10 10 10 10 10
10 10 10 10 10 10 10 10 10
10 10 10 10 10 10 10 10 10
10 10 10 10 10 10 10 10 10
10 10 10 10 10 10 10 10 10
14 10 14 10 14 10 14 10 14
14 10 14 10 14 10 14 10 14
14 10 14 10 14 10 14 10 14
14 10 14 10 14 10 14 10 14
14 10 14 10 14 10 14 10 14
14 10 14 10 14 10 14 10 14