MODE 2
SIZE 9/9
LIMIT 0/29
COLOR LIMIT 5
STARS 2500/4100/6210
COLLECT COUNT 2/2
COLLECT ITEMS 1/2
10 10 10 10 10 10 10 10 10
10 10 10 10 10 10 10 10 10
10 10 10 10 10 10 10 10 10
10 10 10 10 10 10 10 10 10
10 10 10 10 10 10 10 10 10
10 10 10 10 10 10 10 10 10
14 14 14 14 14 14 14 14 14
14 14 14 14 14 14 14 14 14
14 14 14 14 14 14 14 14 14