MODE 1
SIZE 9/11
LIMIT 1/60
COLOR LIMIT 5
STARS 3900/6500/9600
COLLECT COUNT 45/55
COLLECT ITEMS 4/5
14 10 10 10 10 10 10 10 14
14 10 10 10 10 10 10 10 14
14 10 10 10 10 10 10 10 14
14 10 10 10 10 10 10 10 14
14 10 10 10 10 10 10 10 14
14 10 10 10 10 10 10 10 14
14 10 10 10 10 10 10 10 14
14 10 10 10 10 10 10 10 14
14 10 10 10 10 10 10 10 14
14 14 14 14 14 14 14 14 14
14 14 14 14 14 14 14 14 14