MODE 3
SIZE 9/10
LIMIT 0/25
COLOR LIMIT 5
STARS 4600/7400/8200
COLLECT COUNT 0/0
COLLECT ITEMS 1/2
10 10 10 10 00 10 10 10 10
10 10 10 10 00 10 10 10 10
10 10 10 10 10 10 10 10 10
10 10 10 10 10 10 10 10 10
10 10 10 10 10 10 10 10 10
10 14 10 14 10 14 10 14 10
10 14 10 14 10 14 10 14 10
14 14 14 14 14 14 14 14 14
50 14 50 14 50 14 50 14 50
14 50 14 50 14 50 14 50 14