MODE 1
SIZE 9/11
LIMIT 0/27
COLOR LIMIT 6
STARS 2750/4500/5900
COLLECT COUNT 25/30
COLLECT ITEMS 4/5
10 10 10 10 14 10 10 10 10
10 10 10 10 14 10 10 10 10
10 10 10 10 14 10 10 10 10
10 10 10 10 14 10 10 10 10
10 10 10 10 14 10 10 10 10
10 10 10 14 14 14 10 10 10
10 10 10 14 14 14 10 10 10
10 10 10 14 14 14 10 10 10
10 10 14 14 14 14 14 10 10
10 14 14 14 14 14 14 14 10
14 14 14 14 14 14 14 14 14