MODE 1
SIZE 9/11
LIMIT 1/60
COLOR LIMIT 5
STARS 5300/5900/6500
COLLECT COUNT 35/40
COLLECT ITEMS 1/5
00 00 00 10 10 10 00 00 00
00 00 10 10 10 10 10 00 00
00 10 10 10 14 10 10 10 00
10 10 10 14 14 14 10 10 10
10 10 14 14 14 14 14 10 10
10 14 14 14 14 14 14 14 10
10 10 14 14 14 14 14 10 10
10 10 14 14 14 14 10 10 10
00 10 10 14 14 14 10 10 00
00 00 10 10 14 10 10 00 00
00 00 00 10 10 10 10 00 00