MODE 3
SIZE 9/11
LIMIT 0/15
COLOR LIMIT 5
STARS 19000/24000/50000
COLLECT COUNT 0/0
COLLECT ITEMS 0/0
50 50 50 50 50 50 50 50 50
50 50 50 50 50 50 50 50 50
00 00 50 50 50 50 50 00 00
50 50 50 50 50 50 50 50 50
50 50 50 50 00 50 50 50 50
50 50 50 50 00 50 50 50 50
50 50 50 50 00 50 50 50 50
50 50 50 50 50 50 50 50 50
00 00 50 50 50 50 50 00 00
50 50 50 50 50 50 50 50 50
50 50 50 50 50 50 50 50 50