MODE 3
SIZE 9/11
LIMIT 0/33
COLOR LIMIT 6
STARS 5900/6800/9700
COLLECT COUNT 0/0
COLLECT ITEMS 1/2
00 00 00 00 00 00 10 10 10
00 00 00 00 00 00 10 10 10
00 00 00 00 20 13 10 10 10
00 00 20 20 20 13 10 10 10
20 20 20 20 20 13 10 10 10
20 50 50 50 20 13 10 10 10
20 50 50 50 20 13 10 10 10
20 50 50 50 20 13 10 10 10
20 50 50 50 20 13 10 10 10
20 50 50 50 20 13 10 10 10
20 20 20 20 20 13 10 10 10