MODE 3
SIZE 9/11
LIMIT 0/55
COLOR LIMIT 6
STARS 8500/9600/11200
COLLECT COUNT 0/0
COLLECT ITEMS 1/2
00 00 10 10 10 10 10 00 00
00 10 10 10 10 10 10 10 00
23 10 10 10 10 10 10 10 23
10 10 20 20 20 20 20 10 10
10 20 50 50 50 50 50 20 10
10 20 50 23 23 23 50 20 10
10 20 50 23 23 23 50 20 10
10 20 50 50 50 50 50 20 10
10 10 20 20 20 20 20 10 10
10 10 10 10 10 10 10 10 10
23 10 10 10 10 10 10 10 23