MODE 3
SIZE 9/10
LIMIT 0/28
COLOR LIMIT 5
STARS 4800/5800/6900
COLLECT COUNT 0/0
COLLECT ITEMS 1/2
00 00 10 10 10 10 10 00 00
00 10 10 10 10 10 10 10 00
10 10 10 10 14 10 10 10 10
10 10 10 14 14 14 10 10 10
10 10 14 23 23 23 14 10 10
10 14 14 23 23 23 14 14 10
10 10 14 23 23 23 14 10 10
10 10 10 14 14 14 10 10 10
00 10 10 10 14 10 10 10 00
00 00 10 10 10 10 10 00 00