MODE 1
SIZE 9/10
LIMIT 0/20
COLOR LIMIT 6
STARS 2200/3200/4500
COLLECT COUNT 15/15
COLLECT ITEMS 1/4
10 10 10 10 10 10 10 10 10
10 13 13 13 13 13 13 13 10
10 13 10 10 10 10 10 13 10
10 13 10 10 10 10 10 13 10
10 13 10 10 10 10 10 13 10
10 13 10 10 10 10 10 13 10
10 13 10 10 10 10 10 13 10
10 13 10 10 10 10 10 13 10
10 13 13 13 13 13 13 13 10
10 10 10 10 10 10 10 10 10