MODE 2
SIZE 9/11
LIMIT 0/36
COLOR LIMIT 6
STARS 4000/5800/7000
COLLECT COUNT 1/1
COLLECT ITEMS 1/2
00 00 10 10 10 10 10 00 00
00 00 10 10 10 10 10 00 00
10 10 10 10 10 10 10 10 10
10 10 10 10 10 10 10 10 10
10 10 10 10 10 10 10 10 10
10 10 10 10 10 10 10 10 10
10 10 14 14 14 14 14 10 10
10 10 14 14 14 14 14 10 10
10 10 14 14 10 14 14 10 10
10 10 14 14 10 14 14 10 10
13 13 14 14 13 14 14 13 13