MODE 3
SIZE 9/11
LIMIT 0/48
COLOR LIMIT 5
STARS 9800/11300/13500
COLLECT COUNT 0/0
COLLECT ITEMS 1/2
10 10 10 10 10 10 10 10 10
10 50 10 10 10 10 10 50 10
10 50 23 23 23 23 23 50 10
10 50 00 50 23 50 00 50 10
10 50 00 50 23 50 00 50 10
10 50 23 23 23 23 23 50 10
10 50 23 50 00 50 23 10 10
10 10 23 50 00 50 23 10 10
10 10 10 10 10 10 10 10 10
10 10 10 10 10 10 10 10 10
10 10 10 10 10 10 10 10 10