MODE 3
SIZE 9/11
LIMIT 0/30
COLOR LIMIT 5
STARS 1000/2500/3800
COLLECT COUNT 0/0
COLLECT ITEMS 1/2
10 10 10 10 10 10 10 10 10
00 00 10 10 10 10 10 10 10
10 10 10 10 10 10 10 10 10
10 10 10 10 10 10 10 00 00
10 10 10 10 10 10 10 10 10
14 14 14 14 14 14 14 14 14
10 10 10 10 10 10 10 10 10
10 10 10 10 10 10 10 10 10
17 17 17 17 17 17 17 17 17
14 14 14 14 14 14 14 14 14
23 23 23 23 23 23 23 23 23