MODE 1
SIZE 9/9
LIMIT 1/60
COLOR LIMIT 6
STARS 2900/3600/4800
COLLECT COUNT 25/25
COLLECT ITEMS 3/5
10 10 10 10 10 10 10 10 10
10 10 10 10 10 10 10 10 10
10 10 10 10 10 10 10 10 10
10 10 10 10 10 10 10 10 10
13 13 13 13 13 13 13 13 13
14 14 14 13 17 13 14 14 14
10 10 14 13 10 13 14 10 10
10 10 14 10 10 10 14 10 10
17 10 14 10 10 10 14 10 17