MODE 2
SIZE 9/9
LIMIT 0/21
COLOR LIMIT 5
STARS 4000/5600/6800
COLLECT COUNT 2/2
COLLECT ITEMS 1/2
10 10 10 10 10 10 10 10 10
10 10 10 10 10 10 10 10 10
10 10 10 10 10 10 10 10 10
10 10 10 10 10 10 10 10 10
10 10 10 10 10 10 10 10 10
14 10 10 10 10 10 10 10 14
10 14 10 10 10 10 10 14 10
10 10 14 14 14 14 14 10 10
17 10 10 10 17 10 10 10 17