MODE 3
SIZE 9/10
LIMIT 0/32
COLOR LIMIT 5
STARS 3500/5500/7200
COLLECT COUNT 0/0
COLLECT ITEMS 1/2
50 17 10 10 17 10 10 17 50
17 17 10 10 10 10 10 17 17
10 10 10 10 10 10 10 10 10
10 10 10 10 10 10 10 10 10
00 00 10 10 17 10 10 00 00
00 00 10 10 17 10 10 00 00
10 10 10 10 10 10 10 10 10
10 10 10 10 10 10 10 10 10
17 17 10 10 10 10 10 17 17
50 17 10 10 17 10 10 17 50