MODE 1
SIZE 9/11
LIMIT 1/80
COLOR LIMIT 5
STARS 4500/5800/6900
COLLECT COUNT 15/35
COLLECT ITEMS 1/5
10 10 10 10 13 10 10 10 10
10 10 10 10 13 10 10 10 10
10 10 10 10 13 10 10 10 10
00 00 00 10 13 10 00 00 00
10 10 10 10 13 10 10 10 10
10 10 10 10 13 10 10 10 10
10 10 10 10 13 10 10 10 10
00 00 00 10 13 10 00 00 00
10 10 10 10 13 10 10 10 10
10 10 10 10 13 10 10 10 10
10 10 10 10 13 10 10 10 10