MODE 3
SIZE 9/11
LIMIT 0/51
COLOR LIMIT 4
STARS 8300/15000/28000
COLLECT COUNT 0/0
COLLECT ITEMS 1/2
00 00 00 00 00 10 10 10 10
50 50 50 50 00 10 10 10 10
50 50 50 50 00 10 10 10 10
50 50 50 50 00 10 10 10 10
50 50 50 50 00 10 10 10 10
50 50 50 50 00 10 10 10 10
50 50 50 50 00 10 10 10 10
50 50 50 50 00 10 10 10 10
13 13 13 13 00 14 14 14 14
13 13 13 13 00 14 14 14 14
00 00 00 00 00 17 17 17 17