MODE 3
SIZE 9/11
LIMIT 0/37
COLOR LIMIT 4
STARS 13500/16900/22000
COLLECT COUNT 0/0
COLLECT ITEMS 1/2
00 50 50 50 50 50 50 50 00
00 50 50 50 50 50 50 50 00
00 50 50 50 50 50 50 50 00
00 50 50 50 50 50 50 50 00
00 50 50 50 50 50 50 50 00
00 50 50 50 50 50 50 50 00
00 50 50 50 50 50 50 50 00
00 00 00 00 00 00 00 00 00
10 20 20 20 20 20 20 20 10
00 00 00 00 00 00 00 00 00
10 20 20 20 20 20 20 20 10