MODE 0
SIZE 9/9
LIMIT 0/31
COLOR LIMIT 5
STARS 5500/6800/9800
COLLECT COUNT 0/0
COLLECT ITEMS 1/2
10 10 10 10 00 10 10 10 10
10 10 13 13 14 13 13 10 10
10 10 13 13 14 13 13 10 10
10 14 14 14 14 14 14 14 10
00 14 10 10 17 10 10 14 00
10 14 14 14 14 14 14 14 10
10 10 13 13 14 13 13 10 10
10 10 13 13 14 13 13 10 10
10 10 10 10 00 10 10 10 10