MODE 2
SIZE 9/11
LIMIT 0/36
COLOR LIMIT 4
STARS 2600/4300/5900
COLLECT COUNT 2/1
COLLECT ITEMS 1/2
10 10 10 10 10 10 10 10 10
10 10 10 10 10 10 10 10 10
10 10 10 10 10 10 10 10 10
10 10 10 10 10 10 10 10 10
00 10 10 10 10 10 10 10 00
00 00 14 14 14 14 14 00 00
00 00 14 14 14 14 14 00 00
14 14 14 14 14 14 14 14 14
14 14 14 14 14 14 14 14 14
14 14 14 14 14 14 14 14 14
14 14 14 14 14 14 14 14 14