MODE 2
SIZE 9/11
LIMIT 0/48
COLOR LIMIT 5
STARS 2500/6800/12000
COLLECT COUNT 3/5
COLLECT ITEMS 1/2
10 10 10 10 10 10 10 10 10
10 10 10 10 10 10 10 10 10
10 14 10 10 10 10 10 14 10
10 10 10 10 10 10 10 10 10
10 10 10 10 10 10 10 10 10
10 10 10 10 10 10 10 10 10
14 14 14 14 14 14 14 14 14
14 14 14 14 14 14 14 14 14
14 14 14 14 14 14 14 14 14
17 17 17 17 17 17 17 17 17
10 10 10 10 10 10 10 10 10