MODE 3
SIZE 9/11
LIMIT 0/31
COLOR LIMIT 4
STARS 5000/8900/15000
COLLECT COUNT 0/0
COLLECT ITEMS 1/2
10 00 10 10 10 10 10 00 10
20 00 10 10 10 10 10 00 20
20 00 10 10 10 10 10 00 20
20 00 10 10 10 10 10 00 20
20 00 10 10 10 10 10 00 20
20 00 10 10 10 10 10 00 20
20 00 10 10 10 10 10 00 20
20 00 10 10 10 10 10 00 20
20 00 10 10 10 10 10 00 20
20 00 10 10 10 10 10 00 20
10 00 10 10 10 10 10 00 10