MODE 3
SIZE 9/11
LIMIT 0/46
COLOR LIMIT 6
STARS 2500/3500/5000
COLLECT COUNT 0/0
COLLECT ITEMS 0/0
10 10 10 10 00 10 10 10 10
10 10 10 10 00 10 10 10 10
10 10 10 20 20 20 10 10 10
10 10 20 20 20 20 20 10 10
10 10 20 20 20 20 20 10 10
10 20 20 20 20 20 20 20 10
10 10 20 20 20 20 20 10 10
10 10 20 20 20 20 20 10 10
10 10 10 20 20 20 10 10 10
10 10 10 10 00 10 10 10 10
10 10 10 10 00 10 10 10 10