MODE 2
SIZE 9/11
LIMIT 0/31
COLOR LIMIT 5
STARS 2600/5800/9300
COLLECT COUNT 1/1
COLLECT ITEMS 1/2
10 10 10 10 10 10 10 10 10
10 14 14 10 10 10 14 14 10
10 00 00 10 10 10 00 00 10
10 10 10 10 10 10 10 10 10
10 10 10 10 13 10 10 10 10
10 10 10 10 10 10 10 10 10
10 14 10 10 10 10 10 14 10
10 00 14 14 14 14 14 00 10
10 10 00 00 00 00 00 10 10
10 10 10 10 10 10 10 10 10
10 10 10 10 10 10 10 10 10